20 15
X                  X
X     XX           X
X     X            X
X     X XXXX       X
X     X        XX  X
X     X            X
X     X            X
X     X            X
X                X X
X                  X
XXXXXXXXXXXXXXXXXXXX
XXXXXXXXXXXXXXXXXXXX
XXXXXXXXXXXXXXXXXXXX
XXXXXXXXXXXXXXXXXXXX
XXXXXXXXXXXXXXXXXXXX
