100 31
                                           X                                  X                    X
                                           X                                  X                    X
                                           X      X                           X                    X
                                           X                                  X                    X
                          X     XXXX       X                                 XX                    X
                  XXXX   XXX               X                                 X                     X
X                                      X XXXXXXXXX                           X                     X
X                                      X X        X                          X                     X
X           XXXXXXX                    X X                                   X                     X
X                                      X X                                                         X
X                                      X X                                  XX                     X
X XXXXXXXXXXX                          X            XXXX                    X                      X
X                                      X        XXXXX                       X                      X
X              XXXX              XXXXXXXXXXXXXXXX                           X XXXXXXXXXXX          X
X                               X   X                                      XX    X                 X
X                    XXXXXXXXX  X   X XXXXXXXXXXX                          X    X                  X
X                             X X   X                          ^           X     X                 X
X                             X X   X             X            X          XX     XXXXX             X
X                 XXX         X X   X                          X          X                        X
X                             X X   X                          X         XX                        X
X                             X X   X              XXXX^^^^^^^^X         X                         X
X                 XXX               XXXXXX             XXXXXXXX         XX           X             X
X      XXX XXX                           X                              X                          X
X                                                                      XX                          X
X                                        X                             X                           X
X      XXXXXXXXXX                        X                            XX             X             X
X      X         XX                XX    X                           XX                            X
X      X           XX               XXXXXX                          XX                             X
X^^^^^^X             XX             X    X                         XX                              X
XXXXXXXX               XXXXX^^^^^^^^X    XXXXXXXXXXXXXXXXXXXXXXXXXXX^^^^^^^^^X^^^X^^^X^^^^^^^^^^^^^X
                           XXXXXXXXXX                              XXXXXXXXXXXXXXXXXXXXXXXXXXXXXXXXX
